R 1280 800

NO ./textures/brick.xpm
SO ./textures/metal.xpm
WE ./textures/stone.xpm
EA ./textures/wood.xpm
S ./textures/pillar.xpm

C 138,71,12
F 255,45,89

        1111111111111111111111111
        1000000000110000000000001
        1011000001110002000020001
        1001000000000000000000001
111111111011000001110000000000001
120000000011000001110111110111111
11110111111111011100000010001
11110111111111011101010010001
110000001101010111000000E0021
10002000000000001100000010001
10000000000000001101010010001
1100000111010101111101111000111
11110111 1110101 101111010001 
11111111 1111111 111111111111