R 1280 800

NO ./textures/walltitan.xpm
SO ./textures/walltitan.xpm
WE ./textures/walltitan.xpm
EA ./textures/walltitan.xpm
S ./textures/zeke.xpm

C 56,200,254
F 128,64,0

        1111111111111111111111111
        1000000000110000000000001
        1011000001110002000020001
        10010000000E0000000000001
111111111011000001110000000000001
100000000011000001110111110111111
11110111111111011100000010001
11110111111111011101010010001
11000000110101011100000000021
10002000000000001100000010001
10000000000000001101010010001
1100000111010101111101111000111
11110111 1110101 101111010001 
11111111 1111111 111111111111